
C 225,0,0


F 225,150,0

SO texture/gold_texture.xpm
EA texture/brics_texture.xpm

NO texture/wood_texture.xpm
WE texture/dark_texture.xpm

11111111111111111111
10000000000000000001
10000100000000000001
10000000011101000001
10000000000000000001
10111111111111111111111
10000000000000000001
1000000100000N000001
10000000000000000011
10000000000000000001
11111111111101111111
           101
           101
           101
           101
11111111111101111111
11000100000000000001
10000000010001000001
10000000000000000001
10000000000000000001
10000000000000000001
100000000000000001111111111111
100000000000000001000000000001
100000000000000000011111111101
11111111111101111111       101
           101             101
           101             101
           101             101
           101             101
           101             101
           101             101
           101             101
           101             101
           101             101
         1100011           101
        110000011          101
       11000000011         101
      1100000000011        101
     110000000000011       101
     110001111100011       101
     110001   100011       101
     11000111110011        101
     1100011000011         101
     11111110111           101
           101             101
           101             101
           101             101
           101             101
         1100011           101
        110000011          101
       11000000011         101
      1100000000011        101
     110000000000011       101
     110001111100011       101
     110001   1000111111111101
     110001   1000000000000001
     110001   1111111111111111
     111111